section-0.conf.json,level-0-1.csv,act-0.csv
|, , , , , , , , , , , , , , , ,|, , , , , , , , , , , , ,|
|, , , , , , , , , , , , , , , ,|, , , , , , , , , , , , ,|
|, , , , , , , , , , , , , , , ,|, , , , , , , , , , , ,@,|
|, , , , , , , , , , , , , , , ,|, , , , , , , , , , ,-,-,|
|, , , , , , , , , , , , , , , ,|,h, , , , , , ,#, , , , ,|
|, , , , , , , , , , , , , ,3, ,#,-,-, , , , , , , , , , ,|
|, , , , , ,2, , , , , , , , , ,$, , , , ,#, , , , , , , ,|
|, ,1, , , , , , , , , , ,-,-,-,-,#, , , , , , , ,#, , , ,|
|, ,0, , , , , , , ,#, , , ,4, , ,|, ,a1,, , , , , , , , ,|
|, ,P, , , ,|, , , , , , , , ,h, ,#,#,-,-,-,#, , , , , , ,|
#,-,-,-,-,-,#,-,-,-,-,-,-,-,-,-,-,#, , , , ,#,-,-,-,-,-,-,#